*XXXXXXXXX
*XXXXXXXXX
*****XXXXX
XXXX*XXXXX
XX***XXXXX
XX*XXXXXXX
XX***XXXXX
XX*X*XXXXX
XX*X*XXXXX
XXXXXXXXXX
